1111111111111
1N01000000001
1000010001001
1100000000001
1000010000001
1000000010001
1000000000001
1000000000001
1111111111111