1111111111
1001000001
1010010001
1100N10001
1111111111